### Western Europe ###

ALB = "countries/WestEur.txt" #Albania
AST = "countries/WestEur.txt" #Aussie
AUS = "countries/WestEur.txt" #Austria
BEL = "countries/WestEur.txt" #Belgium
BOM = "countries/WestEur.txt" #Bohemia - needs color
BOS = "countries/WestEur.txt" #Bosnia - needs color
CAL = "countries/WestEur.txt" #Pacific States
CAN = "countries/WestEur.txt" #Canada
CRO = "countries/WestEur.txt" #Croatia
CSA = "countries/WestEur.txt" #American Syndicalist Revolt
DEN = "countries/WestEur.txt" #Denmark
DNF = "countries/WestEur.txt" #Danubia
ENG = "countries/WestEur.txt" #Britain
FIN = "countries/WestEur.txt" #Finland
FLN = "countries/WestEur.txt" #Flanders - needs color
FRA = "countries/WestEur.txt" #North France
GAL = "countries/WestEur.txt" #Galicia-Lodomeria
GER = "countries/WestEur.txt" #Germany
GLG = "countries/WestEur.txt" #Great Lakes Gov.
HAW = "countries/WestEur.txt" #Hawaii
HOL = "countries/WestEur.txt" #Netherlands
HUN = "countries/WestEur.txt" #Hungary
ICE = "countries/WestEur.txt" #Iceland
IRE = "countries/WestEur.txt" #Ireland
ISR = "countries/WestEur.txt" #Israel
ITA = "countries/WestEur.txt" #Italian Republic
ITF = "countries/WestEur.txt" # Sardinia/Republican
LUX = "countries/WestEur.txt" #Luxemburg
MLT = "countries/WestEur.txt" #Malta - needs color
MNT = "countries/WestEur.txt" #Montenegro
MXF = "countries/WestEur.txt" #Maximist Front
NEE = "countries/WestEur.txt" #New England
NFA = "countries/WestEur.txt" #South France
NOR = "countries/WestEur.txt" #Norway
NZL = "countries/WestEur.txt" #Kiwis
PAP = "countries/WestEur.txt" #Papal States
PCO = "countries/WestEur.txt" #Paris Commune
POL = "countries/WestEur.txt" #Poland
POR = "countries/WestEur.txt" #Portugal
QUE = "countries/WestEur.txt" #Quebec
SAF = "countries/WestEur.txt" #South Africa
SCT = "countries/WestEur.txt" #Scotland - do we want to keep this?
SIC = "countries/WestEur.txt" #Two Sicilies
SLO = "countries/WestEur.txt" #Slovenia - needs color
SPR = "countries/WestEur.txt" #Spain
SRD = "countries/WestEur.txt" #Sardinia/Kingdom of Italy
SVK = "countries/WestEur.txt" #Slovakia
SWE = "countries/WestEur.txt" #Sweden
SWI = "countries/WestEur.txt" #Switzerland
TEX = "countries/WestEur.txt" #Union State
UOB = "countries/WestEur.txt" #Syndie Brits
USA = "countries/WestEur.txt" #Restored America
WAL = "countries/WestEur.txt" #Wales - do we want to keep this?
WLL = "countries/WestEur.txt" #Wallonia - needs color
GRL = "countries/WestEur.txt" #Greenland

### Eastern Europe ###

ARM = "countries/EastEur.txt" #Armenia
ARP = "countries/EastEur.txt" #Vernadsky's Russia
AZB = "countries/EastEur.txt" #Azerbaijan
BDC = "countries/EastEur.txt" #Pro-Russian Belarus - can be reused ect.
BLR = "countries/EastEur.txt" #Belarus
BUL = "countries/EastEur.txt" #Bulgaria
CNC = "countries/EastEur.txt" #North Caucasian Confederation - Needs color
CRM = "countries/EastEur.txt" #Crimea - do we want to keep this?
CYP = "countries/EastEur.txt" #Cyprus - needs color
EST = "countries/EastEur.txt" #Estonia
FER = "countries/EastEur.txt" #Far Eastern Russia - do we use this still?
GEO = "countries/EastEur.txt" #Georgia
GRE = "countries/EastEur.txt" #Greece
KAR = "countries/EastEur.txt" #Karelia
KRL = "countries/EastEur.txt" #Kurland
IDU = "countries/EastEur.txt" #Idel-Ural
LAT = "countries/EastEur.txt" #Latvia
LBL = "countries/EastEur.txt" #Legionary Bulgaria - do we use this still?
LIT = "countries/EastEur.txt" #Lithuania
MNR = "countries/EastEur.txt" #Shikhmatov's Russia
PRS = "countries/EastEur.txt" #Shepilov's Russia
ROM = "countries/EastEur.txt" #Romania
RUS = "countries/EastEur.txt" #Russian State
SBL = "countries/EastEur.txt" #Socialist Bulgaria - do we use this still?
SER = "countries/EastEur.txt" #Serbia
SIB = "countries/EastEur.txt" #Siberia - needs color if we keep it
TCC = "countries/EastEur.txt" #Trancaucasian Governorate
TRK = "countries/EastEur.txt" #Turkestan Governorate
TRS = "countries/EastEur.txt" #Transylvania - do we want to keep this?
TUR = "countries/EastEur.txt" #TURKIYE
UKD = "countries/EastEur.txt" #Ukrainian Defense Council - can be reused ect.
UKR = "countries/EastEur.txt" #Ukraine
YUG = "countries/EastEur.txt" #Yugoslavia easter egg?

### Asian ###

BHU = "countries/Asian.txt" #Bhutan
BUR = "countries/Asian.txt" #Burma
CAM = "countries/Asian.txt" #Cambodia
CHI = "countries/Asian.txt" #Guangzhou Government
FNG = "countries/Asian.txt" #Beiyang Government
INS = "countries/Asian.txt" #Indonesia
JAP = "countries/Asian.txt" #Japan
KOR = "countries/Asian.txt" #Korea
KAZ = "countries/Asian.txt" #Kazahstan
KYR = "countries/Asian.txt" #Kirghizstan - needs color
LAO = "countries/Asian.txt" #Laos
MLD = "countries/Asian.txt" #Maldives
MLY = "countries/Asian.txt" #Malaya
MON = "countries/Asian.txt" #Mongolia
NBR = "countries/Asian.txt" #North Borneo
PHI = "countries/Asian.txt" #Philippines
SAR = "countries/Asian.txt" #to be reused
SIA = "countries/Asian.txt" #Thailand
SIK = "countries/Asian.txt" #Xinjiang
SKM = "countries/Asian.txt" #Sikkim
TAI = "countries/Asian.txt" #Taiwan - needs color
TAJ = "countries/Asian.txt" #Tajikistan - needs color
TIB = "countries/Asian.txt" #Tibet
UZB = "countries/Asian.txt" #Uzbekistan - needs color
KHI = "countries/Asian.txt" #Khiva - needs color
BUK = "countries/Asian.txt" #Bukhara - needs color
VIN = "countries/Asian.txt" #Vietnam
VIE = "countries/Asian.txt" #Leftist Vietnam
XSM = "countries/Asian.txt" #Ma Clique
LEP = "countries/Asian.txt" #League of Eigth Provinces

### Indian ###

# BHC = "countries/Indian.txt"
CEY = "countries/Indian.txt" #Ceylon
IND = "countries/Indian.txt" #India
MAD = "countries/Indian.txt" #Madras
MYS = "countries/Indian.txt" #Mysore
NEP = "countries/Indian.txt" #Nepal
TRV = "countries/Indian.txt" #Travancore
PAK = "countries/Indian.txt" #Pakistan

### Middle East ### 

AFG = "countries/MidEast.txt" #Afghanistan
ALG = "countries/MidEast.txt" #Algeria
AMR = "countries/MidEast.txt" #Accord Morocco
ARA = "countries/MidEast.txt" #Saudi Arabia
CYR = "countries/MidEast.txt" #Cyrenaica
EGY = "countries/MidEast.txt" #Egypt
IRQ = "countries/MidEast.txt" #Iraq
KUR = "countries/MidEast.txt" #Kurdistan
LEB = "countries/MidEast.txt" #Lebanon
MOR = "countries/MidEast.txt" #Morocco
MUS = "countries/MidEast.txt" #Muscat - MENA team can reuse this
OMA = "countries/MidEast.txt" #Oman
PAL = "countries/MidEast.txt" #Palestine
PER = "countries/MidEast.txt" #Iran
SYR = "countries/MidEast.txt" #Syria
BSY = "countries/MidEast.txt" #Baathist Syria
TUN = "countries/MidEast.txt" #Tunisia
YEM = "countries/MidEast.txt" #Yemen

### South/Central America ###

ARG = "countries/WestEur.txt" #Argentina
BRA = "countries/WestEur.txt" #Brazil
CHL = "countries/WestEur.txt" #Chile
COL = "countries/WestEur.txt" #Colombia
CUB = "countries/WestEur.txt" #Cuba
DOM = "countries/WestEur.txt" #Dominican Republic
ECU = "countries/WestEur.txt" #Ecuador
GUY = "countries/WestEur.txt" #Guyana
MEX = "countries/WestEur.txt" #Mexico
PRI = "countries/WestEur.txt" # Puerto Rico
PRU = "countries/WestEur.txt" #Peru
RGS = "countries/WestEur.txt" #SÃ£o Borja Republic
URG = "countries/WestEur.txt" #Uruguay
VEN = "countries/WestEur.txt" #Venezuela

BOL = "countries/SouthAm.txt" #Bolivia
CEN = "countries/SouthAm.txt" #Central America
COS = "countries/SouthAm.txt" #Costa Rica
ELS = "countries/SouthAm.txt" #El Salvador
GUA = "countries/SouthAm.txt" #Guatemala
HON = "countries/SouthAm.txt" #Honduras
NIC = "countries/SouthAm.txt" #Nicaragua
PAN = "countries/SouthAm.txt" #Panama
PAR = "countries/SouthAm.txt" #Paraguay
PRF = "countries/SouthAm.txt" #Abrillist Paraguay

JAM = "countries/African.txt" #Jamaica
HAI = "countries/African.txt" #Haiti
TRI = "countries/African.txt" #Trinidad and Tobago

### African ###

ANG = "countries/African.txt" #Angola
BOT = "countries/African.txt" #Botswana
BRD = "countries/African.txt" #Burundi - needs color
BRT = "countries/African.txt" #Barotseland
BUG = "countries/African.txt" #Buganda
CEA = "countries/African.txt" #Ubangi-Shari - needs color
CHD = "countries/African.txt" #Chad 
CIV = "countries/African.txt" #Ivory Coast - needs color
CNR = "countries/African.txt" #Congo
COG = "countries/African.txt" #Kongo Kingdom - can be reused if no Congo war
DAH = "countries/African.txt" #Dahomey
ERT = "countries/African.txt" #Eritrea - needs color
ETH = "countries/African.txt" #Ethiopia
GAB = "countries/African.txt" #Gabon - 
GAU = "countries/African.txt" #Union of Gabon
GAM = "countries/African.txt" #The Gambia - needs color
GHA = "countries/African.txt" #Ghana
GNE = "countries/African.txt" #Guinea-Konakry
GHF = "countries/African.txt" #Federation of Ghana
KAM = "countries/African.txt" #Kamerun - needs color
KIV = "countries/African.txt" #Kivu League - can be reused if no Congo war
KEN = "countries/African.txt" #Kenya
KTG = "countries/African.txt" #Katanga - can be reused if no Congo war
LIB = "countries/African.txt" #Liberia
MAF = "countries/African.txt" #Mittelafrika
MAG = "countries/African.txt" #Malagasy
MAL = "countries/African.txt" #Mali
MLW = "countries/African.txt" #Malawi
MRT = "countries/African.txt" #Mauritania
MTN = "countries/African.txt" #Mau-Mau
MZB = "countries/African.txt" #Mozambique
NAM = "countries/African.txt" #Namibia/Sudwest
NER = "countries/African.txt" #Niger
NGR = "countries/African.txt" #Nigeria
RWA = "countries/African.txt" #Rwanda
SEN = "countries/African.txt" #Senegal
SIE = "countries/African.txt" #Sierra Leone
SOM = "countries/African.txt" #Somalia
SUD = "countries/African.txt" #Sudan
VOL = "countries/African.txt" #Upper Volta
TNZ = "countries/African.txt" #Tanganyika
TOG = "countries/African.txt" #Togoland
UGA = "countries/African.txt" #Uganda
ZAM = "countries/African.txt" #Zambia
ZIM = "countries/African.txt" #Zimbabwe
ZZB = "countries/African.txt" #Zanzibar

####
MAN = "countries/EastEur.txt" #SHUTUP ERRORHANDLER
MEN = "countries/EastEur.txt" #SHUTUP ERRORHANDLER
PRC = "countries/EastEur.txt" #SHUTUP ERRORHANDLER
SOV = "countries/EastEur.txt" #SHUTUP ERRORHANDLER